10 16
WN WN WN WN WN WN WN WN WN WN WN WN WN WN WN WN
WN BS BB BK BT BS BB BK BT BS BB BK BT BS BB WN
WN WN BN WN BN WN BN WN BN WN BN WN BN WN BN WN
WN GN GN GN GN GN GN GN GN GN GN GN GN GN GN WN
WN GN GN GN GN GN GN GN GN GN GN GN GN GN GN WN
WN GN GN GN GN GN GN GN GN GN GN GN GN GN GN WN
WN GN GN GN GN GN GN GN GN GN GN GN GN GN GN WN
WN WN BN WN BN WN BN WN BN WN BN WN BN WN BN WN
WN BS BB BK BT BS BB BK BT BS BB BK BT BS BB WN
WN WN WN WN WN WN WN WN WN WN WN WN WN WN WN WN
4
3 1
3 14
6 1
6 14