13 17
WN WN WN WN WN WN WN WN WN WN WN WN WN WN WN WN WN
WN WN WN BN WN BN WN BN WN BN WN BN WN BN WN WN WN
WN WN GN GN GN GN GN GN GN GN GN GN GN GN GN WN WN
WN BN GN WN BN WN BN WN BN WN BN WN BN WN GN BN WN
WN WN GN BN WN BN WN BN WN BN WN BN WN GN GN WN WN
WN BN GN GN GN GN GN GN WN GN GN GN GN GN GN BN WN
WN WN GN WN BN WN BN WN BN WN BN WN BN WN GN WN WN
WN BN GN GN GN GN GN GN WN GN GN GN GN GN GN BN WN
WN WN GN BN WN BN WN BN WN BN WN BN WN GN GN WN WN
WN BN GN WN BN WN BN WN BN WN BN WN BN WN GN BN WN
WN WN GN GN GN GN GN GN GN GN GN GN GN GN GN WN WN
WN WN WN BN WN BN WN BN WN BN WN BN WN BN WN WN WN
WN WN WN WN WN WN WN WN WN WN WN WN WN WN WN WN WN
4
2 2
2 14
10 2
10 14
