11 15
WN WN WN WN WN WN WN WN WN WN WN WN WN WN WN
WN GN GN BN RN RN RN GN RN RN RN BN GN GN WN
WN GN WN BN WN GN WN GN WN GN WN BN WN GN WN
WN BN BN BN GN BN BN BN BN BN GN BN BN BN WN
WN RN WN GN WN BN WN BN WN BN WN GN WN RN WN
WN RN GN GN GN BN BN WN BN BN GN GN GN RN WN
WN RN WN GN WN BN WN BN WN BN WN GN WN RN WN
WN BN BN BN GN BN BN BN BN BN GN BN BN BN WN
WN GN WN BN WN GN WN GN WN GN WN BN WN GN WN
WN GN GN BN RN RN RN GN RN RN RN BN GN GN WN
WN WN WN WN WN WN WN WN WN WN WN WN WN WN WN
4
1 1
1 13
9 1
9 13