9 13
WN WN WN WN WN WN WN WN WN WN WN WN WN
WN GN GN GN WN RN RN RN WN GN GN GN WN
WN GN GN GN BN RN RN RN BN GN GN GN WN
WN GN GN GN WN RN RN RN WN GN GN GN WN
WN WN WN WN WN WN BN WN WN WN WN WN WN
WN GN GN GN WN RN RN RN WN GN GN GN WN
WN GN GN GN BN RN RN RN BN GN GN GN WN
WN GN GN GN WN RN RN RN WN GN GN GN WN
WN WN WN WN WN WN WN WN WN WN WN WN WN
4
1 1
1 11
7 1
7 11
